111111111111111111111111
100000000000000000000EC1
101111111111111111111111
1P000000000000000C000001
1000000000000000000000C1
111111111111111111111111