111111111111111111111111
1P00000001000000000000E1
111111110111111100001111
100000000111100000001111
1C0000000000000000000001
111111111111111111111111